{
    "1": 50,
    "2": 60,
    "3": 70,
    "4": 80,
    "5": 90,
    "6": 100,
    "7": 110,
    "8": 120,
    "9": 130,
    "10": 140,
    "11": 150,
    "12": 160,
    "13": 170,
    "14": 180,
    "15": 190,
    "16": 200,
    "17": 210,
    "18": 220,
    "19": 230,
    "20": 240,
    "21": 250,
    "22": 260,
    "23": 270,
    "24": 280,
    "25": 290,
    "26": 300,
    "27": 310,
    "28": 320,
    "29": 330,
    "30": 340,
    "31": 350,
    "32": 360,
    "33": 370,
    "34": 380,
    "35": 390,
    "36": 400,
    "37": 410,
    "38": 420,
    "39": 430,
    "40": 440,
    "41": 450,
    "42": 460,
    "43": 470,
    "44": 480,
    "45": 490,
    "46": 500,
    "47": 510,
    "48": 520,
    "49": 530,
    "50": 540,
    "51": 550,
    "52": 560,
    "53": 570,
    "54": 580,
    "55": 590,
    "56": 600,
    "57": 610,
    "58": 620,
    "59": 630,
    "60": 640,
    "61": 650,
    "62": 660,
    "63": 670,
    "64": 680,
    "65": 690,
    "66": 700,
    "67": 710,
    "68": 720,
    "69": 730,
    "70": 740,
    "71": 750,
    "72": 760,
    "73": 770,
    "74": 780,
    "75": 790,
    "76": 800,
    "77": 810,
    "78": 820,
    "79": 830,
    "80": 840,
    "81": 850,
    "82": 860,
    "83": 870,
    "84": 880,
    "85": 890,
    "86": 900,
    "87": 910,
    "88": 920,
    "89": 930,
    "90": 940,
    "91": 950,
    "92": 960,
    "93": 970,
    "94": 980,
    "95": 990,
    "96": 1000,
    "97": 1010,
    "98": 1020,
    "99": 1030,
    "100": 1040
}